*************************
SSS---------------------*
SSS---------------------*
*********************---*
*------------------**---*
*------------------**---*
*---************---**---*
*---************---**---*
*-------------**---**---*
*-------------**--------*
**********----**--------*
**********----***********
***-----------***********
***-----------***********
***----******************
***----******************
***----------------------
***----------------------
*************************